################################################################################
#X****************************************************************************X#
#*#####*#####*#####*#####*#####*#####*####*#####*#####*#####*#####*#####*#####*#
#*#####*#####*#####*#####*#####*#####*####*#####*#####*#####*#####*#####*#####*#
#*#####*#####*#####*#####*#####*#####*####*#####*#####*#####*#####*#####*#####*#
#*#####*#####*#####*#####*#####*#####*####*#####*#####*#####*#####*#####*#####*#
#******************************************************************************#
#*#####*#####*#####*#####*#####*#####*####*#####*#####*#####*#####*#####*#####*#
#*#####*#####*#####*#####*#####*#####*####*#####*#####*#####*#####*#####*#####*#
#*#####*#####*#####*#####*#####*#####*####*#####*#####*#####*#####*#####*#####*#
#*#####*#####*#####*#####*#####*#####*####*#####*#####*#####*#####*#####*#####*#
#*****************************************Q************************************#
#*#####*#####*#####*#####*#####*#####*####*#####*#####*#####*#####*#####*#####*#
#*#####*#####*#####*#####*#####*#####*####*#####*#####*#####*#####*#####*#####*#
#*#####*#####*#####*#####X#####*#####*####*#####*#####*#####*#####*#####*#####*#
#*#####*#####*#####*#####*#####*#####*####*#####*#####*#####*#####*#####*#####*#
#******************************************************************************#
#*#####*#####*#####*#####*#####*#####*####*#####*#####*#####*#####*#####*#####*#
#*#####*#####*#####*#####*#####*#####*####*#####*#####*#####*#####*#####*#####*#
#*#####*#####*#####*#####*#####*#####*####*#####*#####*#####*#####*#####*#####*#
#*#####*#####*#####*#####*#####*#####*####*#####*#####*#####*#####*#####*#####*#
#*#####*#####*#####*#####*#####*#####*####*#####*#####*#####*#####*#####*#####*#
#X****************************************************************************X#
################################################################################